WWWWWWWWWWWWWWWWWWWWWWWWWWWWWWW
W     W     W       W   WWWWWWW
W   WWW     WW    WWW         W
W   W    W   WW            W  W
W   W    W   WW            W  W
W   W   WW    WW   WWW  WWWW  W
W  WW   WW    W      W  W     W
W       W            W  W     W
W      W    PPP       W  W  WWW
W       W            W  W  WWWW
WWWWWWWWWWWWWWWWWWWWWWWWWWWWWWW